############
#        O #
#   P   ####
#          #
#######    #
# O  ##    ######
#    ##         #
#          ######
#       XX #
#        # #
############
