#########
#PO X # #
#       #
# XXXXX #
# OOO   #
# O O   #
#       #
#########
