            
#      # O #
# # P #   ##
#  #     X #
##         #
# O  ##X   ######
#    ##  #      #
#          ######
#          #
#          #
############
