##############
#           O#
#  P   ########
#             #
#######     ###
# O  ##       #
#    ##       #
#             #
#        XX   #
#         #   #
##############
