## #########
#        O #
#   P   ####
# O         #
#######          t
#    ##    #
#    ##    #
#          #
#       X       
        # #
###  ######
